

NO          textures/einstein.png
SO textures/socrate.png
WE textures/epicure.png

EA textures/voltaire.png


D textures/door_128x128.png


C               180,200,255   
F   180,100,50


        1111111111111111111111111
        1000000000110000000000001
        10101100001110000000000001
        100100X000P0000X0000000W1
111111111011000001110000000000001
100000000011000001100011111111111
111101111111111111111001111111111
11110111111101111111110111111
11110111111100011101010010001
11110111X11110011101010010001
11000000110100011000000110001
10000000000000011100000110001
100000000000000000000000100001
110000011101010111110111100111
11110111 1110101 101111010001
11111111 1111111 111111111111
